pro,source,index_crime_against_person_murder,index_crime_against_person_homicide,index_crime_against_person_physical_injury,index_crime_against_person_rape,index_crime_agianst_property_robbery,index_crime_against_property_theft,index_crime_against_property_carnapping,index_crime_against_property_cattle_rustling,index_crime_total,index_crime_ave_monthly_rate,index_crime_total_cleared,index_crime_clearance_efficiency,index_crime_solved,index_crime_soln_efficiency,nonindex_crime_violation_of_special_laws,nonindex_crime_others,nonindex_crime_total,nonindex_crime_cleared,nonindex_crime_solved,total_crime_vol,total_crime_cleared,crime_clearance_efficiency,total_crimes_solved,crime_soln_efficiency,ave_monthly_crime_rate,popn_dprm
1,PNP Blotter,350,491,11982,494,1296,5043,495,248,20399,33.83,12876,63.12,10049,49.26,5891,16477,22368,17218,13805,42767,30094,70.37,23854,55.78,70.93,5024204
1,Brgy Blotter,2,1,3226,9,63,457,1,1,3760,6.24,1703,-,1099,29.23,215,4855,5070,2288,1775,8830,3991,-,2874,-,14.65,5024204
1,OLEA,0,12,260,3,4,23,1,0,303,0.5,261,-,69,22.77,37,2305,2342,2316,2310,2645,2577,-,2379,-,4.39,5024204
2,PNP Blotter,258,455,4288,341,700,1314,314,32,7702,18.78,4913,63.79,4103,53.27,1999,5051,7050,4781,3953,14752,9694,65.71,8056,54.61,35.98,3416745
2,Brgy Blotter,1,5,1243,0,14,207,3,4,1477,3.6,1383,-,1075,72.78,167,1475,1642,1480,1208,3119,2863,-,2283,-,7.61,3416745
2,OLEA,1,35,107,0,0,0,12,0,155,0.38,35,-,24,15.48,108,21,129,107,104,284,142,-,128,-,0.69,3416745
3,PNP Blotter,578,801,14934,883,3457,7766,1415,50,29884,23.21,15785,52.82,11202,37.48,9444,27485,36929,24480,17015,66813,40265,60.27,28217,42.23,51.89,10729217
3,Brgy Blotter,0,2,8954,15,424,3742,36,10,13183,10.24,5203,-,4822,36.58,1802,16625,18427,8033,7040,31610,13236,-,11862,-,24.55,10729217
3,OLEA,0,0,10,2,1,7,0,0,20,0.02,4,-,3,15,26,9,35,13,11,55,17,-,14,-,0.04,10729217
4A,PNP Blotter,1302,814,7838,957,2490,3900,1211,27,18539,11.58,10333,55.74,6371,34.37,10025,11819,21844,16967,11925,40383,27300,67.6,18296,45.31,25.22,13342305
4A,Brgy Blotter,1,7,5824,3,461,3506,20,6,9828,6.14,3801,-,3231,32.88,1197,10595,11792,5016,4386,21620,8817,-,7617,-,13.5,13342305
4A,OLEA,2,0,26,10,33,73,35,0,179,0.11,76,-,62,34.64,261,152,413,303,229,592,379,-,291,-,0.37,13342305
4B,PNP Blotter,238,203,5018,334,896,1965,217,35,8906,25.56,2956,33.19,1801,20.22,3906,6190,10096,3777,2178,19002,6733,35.43,3979,20.94,54.53,2904108
4B,Brgy Blotter,15,2,1817,4,40,835,18,8,2739,7.86,1488,-,1334,48.7,283,4501,4784,2907,2524,7523,4395,-,3858,-,21.59,2904108
4B,OLEA,9,3,38,14,19,26,2,0,111,0.32,38,-,23,20.72,390,2183,2573,1613,1766,2684,1651,-,1789,-,7.7,2904108
5,PNP Blotter,454,361,11997,709,2086,7521,397,134,23659,34.38,10925,46.18,6332,26.76,10192,21726,31918,17632,10337,55577,28557,51.38,16669,29.99,80.75,5735282
5,Brgy Blotter,3,5,2600,14,152,1441,19,11,4245,6.17,1785,-,485,11.43,760,7006,7766,4245,1659,12011,6030,-,2144,-,17.45,5735282
5,OLEA,12,4,22,18,15,58,2,0,131,0.19,20,-,28,21.37,197,158,355,144,79,486,164,-,107,-,0.71,5735282
6,PNP Blotter,572,709,21409,832,3650,15874,491,194,43731,48.49,6948,15.89,3800,8.69,15064,39608,54672,10029,5585,98403,16977,17.25,9385,9.54,109.12,7515017
6,Brgy Blotter,0,21,18031,46,143,5338,7,13,23599,26.17,3,-,0,0,1029,39229,40258,0,0,63857,3,-,0,-,70.81,7515017
6,OLEA,1,3,109,4,7,63,0,0,187,0.21,0,-,0,0,687,274,961,2,0,1148,2,-,0,-,1.27,7515017
7,PNP Blotter,745,602,15245,486,5613,13670,940,102,37403,43.32,15467,41.35,12276,32.82,13533,29835,43368,27512,24612,80771,42979,53.21,36888,45.67,93.55,7195201
7,Brgy Blotter,0,0,9016,17,803,4286,104,21,14247,16.5,0,-,0,0,2267,31215,33482,0,0,47729,0,-,0,-,55.28,7195201
7,OLEA,1,3,59,6,7,21,1,1,99,0.11,0,-,0,0,1267,162,1429,0,0,1528,0,-,0,-,1.77,7195201
8,PNP Blotter,489,217,5286,220,858,3734,71,25,10900,20.93,3311,30.38,2077,19.06,2550,6985,9535,3833,2424,20435,7144,34.96,4501,22.03,39.24,4339567
8,Brgy Blotter,17,45,3691,16,95,1478,20,5,5367,10.31,2347,-,1724,32.12,1296,6370,7666,2797,1752,13033,5144,-,3476,-,25.03,4339567
8,OLEA,2,23,858,5,23,142,7,0,1060,2.04,580,-,385,36.32,780,1420,2200,596,429,3260,1176,-,814,-,6.26,4339567
9,PNP Blotter,647,286,7420,333,1565,4778,608,118,15755,36.42,5773,36.64,4084,25.92,6991,10671,17662,8020,5890,33417,13793,41.28,9974,29.85,77.24,3605285
9,Brgy Blotter,11,14,5884,20,66,1092,6,18,7111,16.44,2153,-,1542,21.68,955,11006,11961,4325,4521,19072,6478,-,6063,-,44.08,3605285
9,OLEA,3,3,194,11,28,109,1,0,349,0.81,43,-,25,7.16,390,251,641,171,206,990,214,-,231,-,2.29,3605285
10,PNP Blotter,710,596,11258,415,4237,14566,1075,361,33218,60.88,5439,16.37,4102,12.35,12407,28448,40855,9809,8965,74073,15248,20.59,13067,17.64,135.76,4546954
10,Brgy Blotter,0,0,0,0,0,0,0,0,0, -   ,0,-,0,-,0,0,0,0,0,0,0,-,0,-, -   ,4546954
10,OLEA,0,0,0,0,0,0,0,0,0, -   ,0,-,0,-,149,98,247,0,0,247,0,-,0,-,0.45,4546954
11,PNP Blotter,532,261,10788,567,3346,9755,318,46,25613,45.14,6226,24.31,5226,20.4,15618,18854,34472,14167,12192,60085,20393,33.94,17418,28.99,105.9,4728141
11,Brgy Blotter,1,5,5214,7,253,2563,6,52,8101,14.28,2357,-,2252,27.8,1050,13128,14178,4973,4780,22279,7330,-,7032,-,39.27,4728141
11,OLEA,6,0,20,9,3,85,1,0,124,0.22,74,-,86,69.35,680,125,805,379,341,929,453,-,427,-,1.64,4728141
12,PNP Blotter,611,307,10871,371,2898,6407,779,237,22481,43.08,7797,34.68,5450,24.24,8152,10695,18847,12569,9478,41328,20366,49.28,14928,36.12,79.2,4348295
12,Brgy Blotter,31,15,1531,12,216,955,18,78,2856,5.47,1359,-,1082,37.89,664,8484,9148,5556,3802,12004,6915,-,4884,-,23.01,4348295
12,OLEA,2,7,273,11,7,65,3,1,369,0.71,274,-,263,71.27,652,755,1407,1002,843,1776,1276,-,1106,-,3.4,4348295
13,PNP Blotter,381,191,2396,241,904,2082,173,19,6387,20.71,2986,46.75,2175,34.05,4188,2942,7130,4648,3869,13517,7634,56.48,6044,44.71,43.82,2570337
13,Brgy Blotter,0,0,1563,1,14,425,4,0,2007,6.51,477,-,445,22.17,189,2640,2829,617,564,4836,1094,-,1009,-,15.68,2570337
13,OLEA,0,0,151,3,26,88,0,0,268,0.87,59,-,57,21.27,269,51,320,37,28,588,96,-,85,-,1.91,2570337
ARMM,PNP Blotter,478,101,1575,123,436,712,318,82,3825,9.25,1315,34.38,1134,29.65,722,1581,2303,971,798,6128,2286,37.3,1932,31.53,14.82,3445289
ARMM,Brgy Blotter,0,0,39,0,8,6,0,0,53,0.13,7,-,6,11.32,16,49,65,16,1,118,23,-,7,-,0.29,3445289
ARMM,OLEA,0,0,0,0,0,0,0,0,0, -   ,0,-,0,-,0,0,0,0,0,0,0,-,0,-, -   ,3445289
COR,PNP Blotter,98,135,4819,242,1279,5035,310,21,11939,58.16,8327,69.75,7590,63.57,2880,8087,10967,8970,8319,22906,17297,75.51,15909,69.45,111.58,1710791
COR,Brgy Blotter,0,8,738,0,3,51,4,2,806,3.93,0,-,0,0,80,739,819,0,0,1625,0,-,0,-,7.92,1710791
COR,OLEA,0,0,20,16,18,40,2,0,96,0.47,0,-,0,0,95,42,137,0,0,233,0,-,0,-,1.13,1710791
NCR,PNP Blotter,710,477,10603,1325,13536,20046,3209,0,49906,33.15,24115,48.32,16592,33.25,16695,89189,105884,94158,79943,155790,118273,75.92,96535,61.96,103.49,12545207
NCR,Brgy Blotter,0,0,22508,26,6361,18939,159,0,47993,31.88,37875,-,28280,58.93,7913,49877,57790,50170,35591,105783,88045,-,63871,-,70.27,12545207
NCR,OLEA,2,5,36,2,37,39,0,0,121,0.08,97,-,48,39.67,27,28,55,52,44,176,149,-,92,-,0.12,12545207
GRAND TOTAL,GRAND TOTAL,9276,7235,251789,9177,58591,170328,12833,1962,521191,44.45,208994,-,152814,-,166155,551471,717626,378699,297281,1238817,587693,47.44,450095,36.33,105.66,97701945
AMCR,AMCR,0.79,0.62,21.48,0.78,5,14.53,1.09,0.17,44.45,-,-,-,-,-,14.17,47.04,61.21,-,-,105.66,-,-,-,-,-,-
